NO ./textures/map1/flag.xpm
SO ./textures/map1/wall.xpm
WE ./textures/map2/wall2.xpm




EA ./textures/map1/svastika_tmp.xpm



F 120,63,4
C 25,30,244

11111111111111111111111111111111
10000000011111111111111111111111
10000000000000000011000000000111
11000000010110000011100000000001
11111111000000110000000000000011
10111000000001000010000000000011
10000000000000110000000000000111
11110100000100000000000000010001
11000000000W00000000001000000001
11110000000000000000000000000001
11110000000000000001010010000001
11000000000001000000000010001111
10000000000000001100000010000011
10000000000000001101010000000111
11000001110101011111000000000001
11110111 101110101 1011110100011
11111111111111111111111111111111
