NO ./textures/map1/flag.xpm
SO ./textures/map1/wall.xpm
WE ./textures/map2/wall2.xpm




EA ./textures/map1/svastika_tmp.xpm



F 220,100,45
C 25,30,244

        1111111111111111111 11111
        111111111111111111111111
        10000000001100100000000011111
      1101011000001110000000000001      
111111110000001100000000111111111      1111
1011100000000110001000000000001           
100000000000001100000000000001111
11110100001100000000000010001111
1111100000W1000000000111111111111
111100000011000000000000000111111
111100000000000000010100100011111
110000000000010000000000100011111
100000000000000011000000100011111
100000000000000011010100100011111
110000011101010111110111100011111
11110111 101110101 1011110100011111
11111111 11111111111111111111111
 